12 20 14 15 16 17 15 14
21 13 19 18 17 16 13 20
2 22 1 4 5 12 18 21
23 1 3 2 11 6 19 22
24 24 4 3 25 10 32 23
25 27 28 5 7 8 9 31
9 26 7 29 6 28 32 30
10 11 8 26 30 31 27 29